######
##...#
#S.#E#
##...#
######
