######
#...E#
#.#.##
#S..##
######
